{
  "entityMappings" : [ {
    "entity" : "player",
    "id" : 1
  }, {
    "entity" : "wall",
    "id" : 2
  } ],
  "mapInfo" : {
    "width" : 20,
    "height" : 15
  },
  "layout": [
    "0 0 0 0 0 0 0 0 0 0 0 0 0 0 0 0 0 0 0 0",
    "0 0 2 2 2 2 2 2 2 2 2 2 2 2 2 2 2 2 0 0",
    "0 0 2 0 0 0 0 0 0 0 0 0 0 0 0 1 0 2 0 0",
    "0 0 2 0 0 0 0 0 0 0 0 0 0 0 2 0 2 2 0 0",
    "0 0 2 0 0 0 0 0 0 0 0 0 0 0 2 0 0 2 0 0",
    "0 0 2 0 0 0 0 0 0 0 0 0 0 0 0 0 2 2 0 0",
    "0 0 2 0 0 0 0 0 0 0 0 0 0 0 2 0 0 2 0 0",
    "0 0 2 0 0 0 0 0 0 0 0 0 0 0 2 0 2 2 0 0",
    "0 0 2 0 0 0 0 0 0 0 0 0 0 0 2 0 0 2 0 0",
    "0 0 2 0 0 0 0 0 0 0 0 0 0 0 0 0 2 2 0 0",
    "0 0 2 0 0 0 0 0 0 0 0 0 0 0 2 0 0 2 0 0",
    "0 0 2 0 0 0 0 0 0 0 0 0 0 0 2 0 2 2 0 0",
    "0 0 2 0 0 0 0 0 0 0 0 0 0 0 0 0 0 2 0 0",
    "0 0 2 2 2 2 2 2 2 2 2 2 2 2 2 2 2 2 0 0",
    "0 0 0 0 0 0 0 0 0 0 0 0 0 0 0 0 0 0 0"
  ],
  "spawnEvents" : [ ],
  "modeChangeEvents" : [ ]
}