{
  "entityMappings" : [ {
    "entity" : "player",
    "id" : 1
  }, {
    "entity" : "wall",
    "id" : 2
  },
    {
      "entity" : "cookie",
      "id" : 3
    }],
  "mapInfo" : {
    "width" : 20,
    "height" : 15
  },
  "layout": [
    "0 0 0 0 0 0 0 0 0 0 0 0 0 0 0 0 0 0 0 0",
    "0 0 2 2 2 2 2 2 2 2 2 2 2 2 2 2 2 2 0 0",
    "0 0 2 3 0 3 0 3 0 3 0 0 0 0 0 1 0 2 0 0",
    "0 0 2 0 3 0 3 0 3 0 0 0 0 0 0 0 2 2 0 0",
    "0 0 2 0 0 0 0 0 0 0 0 0 0 0 0 0 0 2 0 0",
    "0 0 2 0 0 0 0 0 0 0 0 0 0 0 0 0 2 2 0 0",
    "0 0 2 0 0 0 0 0 0 0 0 0 0 0 0 0 0 2 0 0",
    "0 0 2 0 0 0 0 0 0 0 0 0 0 0 0 0 2 2 0 0",
    "0 0 2 0 0 0 0 0 0 0 0 0 0 0 0 0 0 2 0 0",
    "0 0 2 0 0 0 0 0 0 0 0 0 0 0 0 0 2 2 0 0",
    "0 0 2 0 0 0 0 0 0 0 0 0 0 0 0 0 0 2 0 0",
    "0 0 2 0 0 0 0 0 0 0 0 0 0 0 0 0 2 2 0 0",
    "0 0 2 0 0 0 0 0 0 0 0 0 0 0 0 0 0 2 0 0",
    "0 0 2 2 2 2 2 2 2 2 2 2 2 2 2 2 2 2 0 0",
    "0 0 0 0 0 0 0 0 0 0 0 0 0 0 0 0 0 0 0"
  ],
  "spawnEvents" : [ ],
  "modeChangeEvents" : [ ]
}