{
  "entityMappings": [
    {
      "entity": "pacman",
      "id": 1
    },
    {
      "entity": "redghost",
      "id": 2
    },
    {
      "entity": "blueghost",
      "id": 3
    },
    {
      "entity": "wall",
      "id": 5
    },
    {
      "entity": "dot",
      "id": 6
    },
    {
      "entity": "tunnel",
      "id": 7
    }
  ],
  "settings": {
    "width": 28,
    "height": 32,
    "edgePolicy": "Wrap"
  },
  "layout": [
    "5 5 5 5 5 5 5 5 5 5 5 5 5 5 5 5 5 5 5 5 5 5 5 5 5 5 5 5",
    "5 6 6 6 6 6 6 6 6 6 6 6 6 5 5 6 6 6 6 6 6 6 6 6 6 6 6 5",
    "5 6 5 5 5 5 6 5 5 5 5 5 6 5 5 6 5 5 5 5 5 6 5 5 5 5 6 5",
    "5 6 5 5 5 5 6 5 5 5 5 5 6 5 5 6 5 5 5 5 5 6 5 5 5 5 6 5",
    "5 6 5 5 5 5 6 5 5 5 5 5 6 5 5 6 5 5 5 5 5 6 5 5 5 5 6 5",
    "5 6 6 6 6 6 6 6 6 6 6 6 6 6 6 6 6 6 6 6 6 6 6 6 6 6 6 5",
    "5 6 5 5 5 5 6 5 5 6 5 5 5 5 5 5 5 5 6 5 5 6 5 5 5 5 6 5",
    "5 6 5 5 5 5 6 5 5 6 5 5 5 5 5 5 5 5 6 5 5 6 5 5 5 5 6 5",
    "5 6 6 6 6 6 6 5 5 6 6 6 6 5 5 6 6 6 6 5 5 6 6 6 6 6 6 5",
    "5 5 5 5 5 5 6 5 5 5 5 5 0 5 5 0 5 5 5 5 5 6 5 5 5 5 5 5",
    "5 5 5 5 5 5 6 5 5 5 5 5 0 5 5 0 5 5 5 5 5 6 5 5 5 5 5 5",
    "5 5 5 5 5 5 6 5 5 0 0 2 0 0 0 0 0 0 0 5 5 6 5 5 5 5 5 5",
    "5 5 5 5 5 5 6 5 5 0 5 5 5 0 0 5 5 5 0 5 5 6 5 5 5 5 5 5",
    "5 5 5 5 5 5 6 5 5 0 5 0 0 0 0 0 0 5 0 5 5 6 5 5 5 5 5 5",
    "7 0 0 0 0 0 6 0 0 0 5 0 0 0 0 0 0 5 0 0 0 6 0 0 0 0 0 7",
    "5 5 5 5 5 5 6 5 5 0 5 0 0 0 0 1 0 5 0 5 5 6 5 5 5 5 5 5",
    "5 5 5 5 5 5 6 5 5 0 5 5 5 5 5 5 5 5 0 5 5 6 5 5 5 5 5 5",
    "5 5 5 5 5 5 6 5 5 0 0 0 0 0 0 0 0 0 3 5 5 6 5 5 5 5 5 5",
    "5 5 5 5 5 5 6 5 5 0 5 5 5 5 5 5 5 5 0 5 5 6 5 5 5 5 5 5",
    "5 5 5 5 5 5 6 5 5 0 5 5 5 5 5 5 5 5 0 5 5 6 5 5 5 5 5 5",
    "5 6 6 6 6 6 6 6 6 6 6 6 6 5 5 6 6 6 6 6 6 6 6 6 6 6 6 5",
    "5 6 5 5 5 5 6 5 5 5 5 5 6 5 5 6 5 5 5 5 5 6 5 5 5 5 6 5",
    "5 6 5 5 5 5 6 5 5 5 5 5 6 5 5 6 5 5 5 5 5 6 5 5 5 5 6 5",
    "5 6 6 6 5 5 6 6 6 6 6 6 6 0 0 6 6 6 6 6 6 6 5 5 6 6 6 5",
    "5 5 5 6 5 5 6 5 5 6 5 5 5 5 5 5 5 5 6 5 5 6 5 5 6 5 5 5",
    "5 5 5 6 5 5 6 5 5 6 5 5 5 5 5 5 5 5 6 5 5 6 5 5 6 5 5 5",
    "5 6 6 6 6 6 6 5 5 6 6 6 6 5 5 6 6 6 6 5 5 6 6 6 6 6 6 5",
    "5 6 5 5 5 5 5 5 5 5 5 5 6 5 5 6 5 5 5 5 5 5 5 5 5 5 6 5",
    "5 6 5 5 5 5 5 5 5 5 5 5 6 5 5 6 5 5 5 5 5 5 5 5 5 5 6 5",
    "5 6 6 6 6 6 6 6 6 6 6 6 6 6 6 6 6 6 6 6 6 6 6 6 6 6 6 5",
    "5 5 5 5 5 5 5 5 5 5 5 5 5 5 5 5 5 5 5 5 5 5 5 5 5 5 5 5"
  ]
}